###############
#S    #       #
#####    ######
###   #########
#####E#########