###############
#     #      S#
#####    ######
###   #########
#####E#########