###############
#     #       S
#####    ######
###   #########
#####E#########